5, 11, 2
1, 1, 1, 1, 1, 1, 1, 1, 1, 1, 1
2, 2, 255, 255, 2, 34, 2, 255, 255, 2, 2
3, 3, 255, 255, 3, 17, 3, 255, 255, 3, 3
4, 4, 4, 4, 4, 4, 4, 4, 4, 4, 4
5, 5, 5, 5, 5, 5, 5, 5, 5, 5, 5
2
50, 39
32, 33, 32, 22
120, 39
112, 33, 32, 22
