5, 11, 2
1, 1, 1, 1, 1, 1, 1, 1, 1, 1, 1
0, 30, 30, 30, 0, 0, 0, 30, 30, 30, 0
0, 6, 64, 6, 0, 0, 0, 6, 64, 6, 0
0, 6, 6, 6, 0, 0, 0, 6, 6, 6, 0
1, 1, 1, 1, 1, 1, 1, 1, 1, 1, 1