5, 11, 2
1, 1, 1, 1, 1, 1, 1, 1, 1, 1, 1
2, 2, 2, 2, 2, 2, 2, 2, 2, 2, 2
3, 3, 18, 9, 3, 3, 3, 9, 18, 3, 3
4, 4, 4, 4, 4, 4, 4, 4, 4, 4, 4
5, 5, 5, 5, 5, 5, 5, 5, 5, 5, 5


